..#......#
#......#..
#.....##..
..##......
......##..
..#.......
.........#
..##...#..
.##....#.#
.......#..
